A N DEV NAGAR - ACND
CHENGANNUR - CNGR
JAWAD ROAD - JWO
MAYYANAD - MYY
RURA - RURA
ABHAIPUR - AHA
CHENNAI BEACH - MSB
JAWAI BANDH - JWB
MCCLUSKIEGANJ - MGME
RUSERA GHAT - ROA
ABOHAR - ABS
CHENNAI CENTRAL - MAS
JAWALI - JAL
MECHEDA - MCA
RUTHIYAI - RTA
ABU ROAD - ABR
CHENNAI EGMORE - MS
JAYASINGPUR - JSP
MECHERI ROAD - MCRD
S BHAKHTIYARPUR - SBV
ACHALDA - ULD
CHEOKI - COI
JAYNAGAR - JYG
MEDAPADU - MPU
SABARMATI JN - SBT
ACHHNERA JN - AH
CHERUKARA - CQA
JEHANABAD - JHD
MEDCHAL - MED
SABARMATI JN - SBI
ADAVALI - ADVI
CHETTINAD - CTND
JEJURI - JJR
MEERUT CANT - MUT
SABAUR - SBO
ADESAR - AAR
CHHABRA GUGOR - CAG
JERUWA KHERA - JRK
MEERUT CITY - MTC
SACHIN - SCH
ADHARTAL - ADTL
CHHANERA - CAER
JETALSAR JN - JLR
MEGHNAGAR - MGN
SADAT - SDT
ADILABAD - ADB
CHHAPI - CHP
JEUR - JEUR
MEHNAR ROAD - MNO
SADISOPUR - SDE
ADINA - ADF
CHHAPRA - CPR
JEYPORE - JYP
MEHSI - MAI
SADULPUR JN - SDLP
ADIPUR - AI
CHHAPRA KACHERI - CI
JHAJHA - JAJ
MEJA ROAD - MJA
SAFDARGANJ - SGJ
ADITYAPUR - ADTP
CHHARODI - CE
JHALAWAR ROAD - JHW
MELATTUR - MLTR
SAFEDABAD - SFH
ADONI - AD
CHHATNA - CJN
JHALIDA - JAA
MELMARUVATTUR - MLMR
SAGADAPATA - SGDP
ADRA JN - ADRA
CHHINDWARA JN - CWA
JHALWARA - JLW
MERALGRAM - MQX
SAGAR JAMBAGARU - SRF
ADRSH NGR DELHI - ANDI
CHHIPADOHAR - CPDR
JHANSI JN - JHS
MERAMANDOLIL - MRDL
SAGARDIGHI - SDI
ADUTURAI - ADT
CHHULHA - CLF
JHANTIPAHARI - JPH
MERTA ROAD JN - MTD
SAGAULI JN - SGL
AGARTALA - AGTL
CHIDAMBARAM - CDM
JHARGRAM - JGM
METUPALAIYAM - MTP
SAGONI - SAO
AGORI KHAS - AGY
CHIHERU - CEU
JHARSUGUDA JN - JSG
METUR DAM - MTDM
SAHARANPUR - SRE
AGRA CANTT - AGC
CHIKHLI - CKHS
JHINJHAK - JJK
MHASODA DONGAR - MSDG
SAHARSA JN - SHC
AGRA CITY - AGA
CHIKJAJUR JN - JRU
JIAGANJ - JJG
MHMDVD KHEDA RD - MHD
SAHARSRAKUND - SHSK
AGRA FORT - AF
CHIKNI ROAD - CKNI
JIND JN - JIND
MIDNAPORE - MDN
SAHATWAR - STW
AHMADGARH - AHH
CHIKODI ROAD - CKR
JIRADEI - ZRDE
MIGRENDISA - MGE
SAHIBABAD - SBB
AHMADNAGAR - ANG
CHILAKALAPUDI - CLU
JIRANIA - JRNA
MIHINPURWA - MIN
SAHIBGANJ JN - SBG
AHMADPUR JN - AMP
CHILBILA JN - CIL
JMLPR SHAIKHAN - JPS
MIHRAWAN - MIH
SAHIBPUR KML JN - SKJ
AHMEDABAD JN - ADI
CHILIKIDARA - CLDR
JODHPUR JN - JU
MILAK - MIL
SAHIBZADA ASNGR - SASN
AHRAURA ROAD - ARW
CHILKA - CLKA
JOGAL - JOL
MILAVITTAN - MVN
SAHJANWA - SWA
AISHBAGH - ASH
CHILKAHAR - CHR
JOGBANI - JBN
MINCHNAL - MNL
SAI P NILAYAM - SSPN
AIT - AIT
CHIMA PAHAD - CMW
JOGENDRANAGAR - JGNR
MIRAJ JN - MRJ
SAIDRAJA - SYJ
AITHAL - ATMO
CHINCHLI - CNC
JOGI MAGRA - JOM
MIRANPUR KATRA - MK
SAINAGAR SHIRDI - SNSI
AJMER JN - AII
CHINCHVAD - CCH
JOGIGHOPA - JPZ
MIRCHADHORI - MCQ
SAINTALA - SFC
AJNI - AJNI
CHINNA GANJAM - CJM
JOLARPETTAI - JTJ
MIRTHAL - MRTL
SAINTHIA - SNT
AKALKOT ROAD - AKOR
CHINNA SALEM - CHSM
JORAI - JOQ
MIRYALAGUDA - MRGA
SAIYID SARAWAN - SYWN
AKALTARA - AKT
CHIPLUN - CHI
JORAWARNAGAR JN - JVN
MIRZA CHEUKI - MZC
SAKALDIHA - SLD
AKANAPET - AKE
CHIPURUPALLE - CPP
JORHAT TOWN - JTTN
MIRZAPALI - MZL
SAKHI GOPAL - SIL
AKBARGANJ - AKJ
CHIRALA - CLX
JOYCHANDI PAHAR - JOC
MIRZAPUR - MZP
SAKHPUR - SKR
AKBARNAGAR - AKN
CHIRAYINKIL - CRY
JUGAUR - JRR
MISRAULI - MFL
SAKLESHPUR - SKLR
AKBARPUR - ABP
CHIRGAON - CGN
JUGPURA - JRG
MISROD - MSO
SAKRI JN - SKI
AKIVIDU - AKVD
CHIRMIRI - CHRM
JUJUMURA - JUJA
MITHAPUR - MTHP
SAKRIGALI JN - SLJ
AKODIA - AKD
CHIT BARAGAON - CBN
JUKEHI - JKE
MIYAGAM KARJAN - MYG
SAKTESGARH - SKGH
AKOLA JN - AK
CHITRAKOT - CKTD
JULANA - JNA
MIYANA - MINA
SAKTI - SKT
AKSHAYWAT R NGR - AYRN
CHITROD - COE
JUNAGADH JN - JND
MODINAGAR - MDNR
SALAIA - SYA
AKURDI - AKRD
CHITTAPUR - CT
JUNNOR DEO - JNO
MODNIMB - MLB
SALAMATPUR - SMT
alai - ALJ
CHITTARANJAN - CRJ
JUTOGH - JTO
MODRAN - MON
SALAR - SALE
ALAMNAGAR - AMG
CHITTAURGARH - COR
JWALAPUR - JWP
MOGA - MOGA
SALAUNA - SLNA
ALAMPUR - ALMR
CHITTOOR - CTO
KABAKAPUTTUR - KBPR
MOHADI PRGN LNG - MHAD
SALBONI - SLB
ALER - ALER
CHITYALA - CTYL
KACHEGUDA - KCG
MOHANLALGANJ - MLJ
SALEKASA - SKS
ALGAWAN - AIG
CHOLA - CHL
KACHHIA BRIDGE - KCO
MOHITNAGAR - MOP
SALEM JN - SA
ALIA BADA - ALB
CHOPAN - CPU
KADAKAVUR - KVU
MOHIUDDINNAGAR - MOG
SALEM TOWN - SXT
ALIGARH JN - ALJN
CHORVAD ROAD - CVR
KADALUNDI - KN
MOHOL - MO
SALEMPUR JN - SRU
ALIPUR DUAR JN - APDJ
CHOTI KHATU - CTKT
KADAMBUR - KDU
MOHOPE - MHPE
SALICHAUKA ROAD - SCKR
ALLAHABAD CITY - ALY
CHUCHURA - CNS
KADAYNALLUR - KDNL
MOKALSAR - MKSR
SALKAROAD - SLKR
ALLAHABAD JN - ALD
CHUNAR - CAR
KADIRI - KRY
MOKAMEH JN - MKA
SALMARI - SRI
ALLEPPEY - ALLP
CHURAIBARI - CBZ
KADIYAN - KYM
MONDH - MOF
SALOGRA - SLR
ALMATTI - LMT
CHURK - CUK
KADUR - DRU
MONU - MANU
SAMAKHIALI B G - SIOB
ALNAVAR JN - LWR
CHURU - CUR
KAHALGAON - CLG
MOOKAMBIKA ROAD - BYNR
SAMALKHA - SMK
ALUABARI ROAD - AUB
CINNAMARA - CMA
KAHILIYA - KH
MOR - MOR
SAMALKOT JN - SLO
ALUVA - AWY
COIMBATORE JN - CBE
KAIKOLUR - KKLR
MORADABAD - MB
SAMALPATTI - SLY
ALWAR - AWR
COIMBATORE NRTH - CBF
KAILAHAT - KYT
MORAK - MKX
SAMASTIPUR JN - SPJ
AMALNER - AN
COLONELGANJ - CLJ
KAILASAPURAM - KLPM
MORANHAT - MRHT
SAMBA - SMBX
AMALSAD - AML
CUDDALORE PORT - CUPJ
KAIMGANJ - KMJ
MORAPPUR - MAP
SAMBALPUR - SBP
AMARDA ROAD - ARD
CUDDAPAH - HX
KAITHALKUCHI - KTCH
MORBI - MVI
SAMBALPUR CITY - SBPY
AMARGARH - AGR
CUMBUM - CBM
KAJGAON - KJ
MORDAD TANDA - MWK
SAMBALPUR ROAD - SBPD
AMB ANDAURA - AADR
CUTTACK - CTC
KAJRA - KJH
MORENA - MRA
SAMBHAR LAKE - SBR
AMBALA CANT JN - UMB
DABHAURA - DBR
KAJRAT NAWADIH - KYF
MORGRAM - MGAE
SAMDHARI JN - SMR
AMBALA CITY - UBC
DABRA - DBA
KAKARGHATTI - KKHT
MORI BERA - MOI
SAMLAYA JN - SMLA
AMBALAPUZHA - AMPA
DABTARA - DUB
KAKINADA PORT - COA
MORINDA - MRND
SAMNAPUR - SMC
AMBALE - ABLE
DADAR - DDR
KAKINADA TOWN - CCT
MORKADHANA - MKDN
SAMPLA - SPZ
AMBARI FALAKATA - ABFC
DADAR - DR
KAKIRIGUMMA - KKGM
MORWANI - MRN
SAMSI - SM
AMBARNATH - ABH
DADRI - DER
KAKORI - KKJ
MOTH - MOTH
SANAHWAL - SNL
AMBASA - ABSA
DAHANU ROAD - DRD
KALA AKHAR - KQE
MOTICHUR - MOTC
SANAND - SAU
AMBASAMUDRAM - ASD
DAHOD - DHD
KALACHAND - KQI
MOTIPUR - MTR
SANAT NAGAR - SNF
AMBATURAI - ABI
DAKANIYA TALAV - DKNT
KALANAUR KALAN - KLNK
MUDDANURU - MOO
SANCHI - SCI
AMBIKA KALNA - ABKA
DAKHINESWAR - DAKE
KALANWALI - KNL
MUDKHED - MUE
SANDILA - SAN
AMBIKAPUR - ABKP
DALADI - DL
KALAPIPAL - KPP
MUGHAL SARAI JN - MGS
SANEH ROAD - SNX
AMBLI ROAD - ABD
DALAUDA - DLD
KALHAR - KAH
MUHAMMADABAD - MMA
SANGARIA - SGRA
AMBODALA - AMB
DALBHUMGARH - DVM
KALI SINDH - KSH
MUHAMMADGANJ - MDJ
SANGAT - SGF
AMBUR - AB
DALELNAGAR - DLQ
KALIANPUR - KAP
MUKERIAN - MEX
SANGLI - SLI
AMDARA - UDR
DALGAON - DLO
KALIYANGANJ - KAJ
MUKTAPUR - MKPR
SANGMESHWAR - SGR
AMETHI - AME
DALIGANJ - DAL
KALKA - KLK
MUKUNDARAYAPURM - MCN
SANGOLA - SGLA
AMGAON - AGN
DALKOLHA - DLK
KALLAKKUDI PLGH - KKPM
MUL MARORA - MME
SANGRUR - SAG
AMGURI - AGI
DALLI RAJHARA - DRZ
KALLAL - KAL
MULACALACHERUVU - MCU
SANICHARA - SAC
AMLA JN - AMLA
DALMAU JN - DMW
KALLKIRI - KCI
MULANTURUTTI - MNTT
SANJAN - SJN
AMLAI - AAL
DALSINGH SARAI - DSS
KALLURU - KLU
MULI ROAD - MOL
SANKARANKOVIL - SNKL
AMMANABROLU - ANB
DALTONGANJ - DTO
KALMITAR - KLTR
MULKI - MULK
SANKARIDURG - SGE
AMMASANDRA - AMSA
DAMANJODI - DMNJ
KALOL - KLL
MULTAI - MTY
SANKARPUR - SNQ
AMONI - AONI
DAMCHARA - DCA
KALPI - KPI
MUMBAI CENTRAL - BCT
SANOSRA - SOA
AMRAVATI - AMI
DAMOH - DMO
KALUNGA - KLG
MUMBAI CST - CSTM
SANSARPUR - SNRR
AMRITSAR JN - ASR
DANAPUR - DNR
KALUPARA GHAT - KAPG
MUNABAO - MBF
SANT ROAD - SAT
AMROHA - AMRO
DANAULI PHLWRIA - DPL
KALYAN JN - KYN
MUNDERWA - MND
SANTALDIH - SNTD
ANAKAPALLE - AKP
DANDUPUR - DND
KALYANPUR ROAD - KPRD
MUNGAOLI - MNV
SANTALPUR - SNLR
ANAND JN - ANND
DANEA - DNEA
KAMAKHYA - KYQ
MUNIGUDA - MNGD
SANTRAGACHI JN - SRC
ANAND NAGAR - ANDN
DANGOAPOSI - DPS
KAMAKHYAGURI - KAMG
MUNIRABAD - MRB
SANVERDAM CHUCH - SVM
ANAND VIHAR - ANVR
DANIYAWAN BZR H - DNWH
KAMALAPURAM - KKM
MUNROTURUTTU - MQO
SAPATGRAM - SPX
ANAND VIHAR TRM - ANVT
DANTAN - DNT
KAMALGANJ - KLJ
MUPA - MUPA
SAPEKHATI - SPK
ANANDAPURAM - ANF
DAOTUHAJA - DJA
KAMALNAGAR - KMNR
MURADNAGAR - MUD
SAPHALE - SAH
ANANDPUR SAHIB - ANSB
DAPODI - DAPD
KAMALPURGRAM - KLPG
MURARAI - MRR
SARAGBUNDIA - SRBA
ANANTAPUR - ATP
DAPPAR - DHPR
KAMARBANDHA ALI - KXL
MURARPUR - MPY
SARAI - SAI
ANAPARTI - APT
DARA - DARA
KAMAREDDI - KMC
MURDESHWAR - MRDW
SARAI CHANDI - SYC
ANARA - ANR
DARBHANGA JN - DBG
KAMARKUNDU - KQU
MURI - MURI
SARAI KANSRAI - SQN
ANAS - ANAS
DARJEELING - DJ
KAMPTEE - KP
MURIBAHAL - MRBL
SARAI MIR - SMZ
ANAVARDIKHANPET - AVN
DARRITOLA - DTL
KAMPUR - KWM
MURKEONGSELEK - MZS
SARANGPUR - SFW
ANDAL JN - UDL
DARYABAD - DYD
KAMSHET - KMST
MURSHIDABAD - MBB
SARBAHARA - SBRA
ANDHERI - ADH
DASHARATHPUR - DRTP
KAMTAUL - KML
MURTAJAPUR - MZR
SARDARGRAM - SDGM
ANGADIPPURAM - AAM
DASUYA - DZA
KANAKPURA - KKU
MURUKKAMPUZHA - MQU
SARDARNAGAR - SANR
ANGAMALI - AFK
DATIA - DAA
KANALAS JN - KNLS
MUSAFIR KHANA - MFKA
SARDIHA - SUA
ANGUL - ANGL
DAUDPUR - DDP
KANAS ROAD - KASR
MUZAFFARNAGAR - MOZ
SAREIGRAM - SGAM
ANJAR - AJE
DAULATABAD - DLB
KANCHIPURAM - CJ
MUZAFFARPUR JN - MFP
SARERI - SSR
ANJHI SHAHABAD - AJI
DAULATPUR HAT - DLPH
KANDAGHAT - KDZ
MUZZAMPUR NRYN - MZM
SARKONI - SIQ
ANKAI - ANK
DAUND JN - DD
KANDARPUR - KDRP
MYSORE JN - MYS
SARNATH - SRNT
ANKLESHWAR JN - AKV
DAURALA - DRLA
KANDRA - KND
N GHAZIABAD - GZN
SARUPATHAR - SZR
ANKOLA - ANKL
DAUSA - DO
KANGINHAL - KGX
N. PANAKUDI - NPK
SASARAM - SSM
ANKORAH AKORHA - ANH
DAVANGERE - DVG
KANHANGAD - KZE
NABADWIP DHAM - NDAE
SASTHANKOTTA - STKT
ANNAVARAM - ANV
DEBAGRAM - DEB
KANJARI BORIYAV - KBRV
NABENAGAR ROAD - NBG
SATARA - STR
ANNIGERI - NGR
DEGANA JN - DNA
KANKAHA - KKAH
NABHA - NBA
SATHAJAGAT - STJT
ANPARA - ANPR
DEHRADUN - DDN
KANKAVALI - KKW
NABIPUR - NIU
SATHIAON - SAA
ANTAH - ATH
DEHRI ON SONE - DOS
KANKI - KKA
NADAUJ - NDU
SATHIN ROAD - SWF
ANTU - ANTU
DEHU ROAD - DEHR
KANNAPURAM - KPQ
NADBAI - NBI
SATNA - STA
ANUGRAHA N ROAD - AUBR
DELANG - DEG
KANNAUJ - KJN
NADIAD JN - ND
SATROD - STD
ANUPPUR JN - APR
DELHI - DLI
KANNUR - CAN
NADIKODE - NDKD
SATTENAPALLE - SAP
AONLA - AO
DELHI CANTT - DEC
KANOH - KANO
NADWAN - NDW
SATUR - SRT
ARA - ARA
DELHI KISHANGNJ - DKZ
KANPUR ANWRGANJ - CPA
NAGAON - NGAN
SAUGOR - SGO
ARAG - ARAG
DELHI S ROHILLA - DEE
KANPUR CENTRAL - CNB
NAGAPPATTINAM - NGT
SAVARDA - SVX
ARAKKONAM - AJJ
DELHI SAFDARJNG - DSJ
KANSHBAHAL - KXN
NAGAR - NGE
SAVARKUNDLA - SVKD
ARALVAYMOZHI - AAY
DELHI SHAHDARA - DSA
KANSRAO - QSR
NAGAR UNTARI - NUQ
SAVDA - SAV
ARARIYA COURT - ARQ
DEOBAND - DBD
KANTABANJI - KBJ
NAGARI - NG
SAWAI MADHOPUR - SWM
ARAVALI ROAD - AVRD
DEOGHAR - DGHR
KANTH - KNT
NAGARI - NGI
SAWANTWADI ROAD - SWV
ARIGADA - ARGD
DEORI - DOE
KANTHI P H - KATI
NAGARIA SADAT - NRS
SAYAN - SYN
ARIYALUR - ALU
DEORIA SADAR - DEOS
KANYAKUMARI - CAPE
NAGARSOL - NSL
SBB JOGULAMBA H - SBBJ
ARJUNI - AJU
DEOTALA - DOTL
KAPAN - KPNA
NAGARUR - NRR
SEALDAH - SDAH
ARNI ROAD - ARV
DEPUR PH - DPUR
KAPASAN - KIN
NAGARWARA - NWA
SECUNDERABAD JN - SC
ARSIKERE JN - ASK
DEROL - DRL
KAPILAS ROAD - KIS
NAGAUR - NGO
SEHORE - SEH
ARUMUGANERI - ANY
DESARI - DES
KAPSETI - KEH
NAGBHIR JN - NAB
SELU - SELU
ARUNACHAL - ARCL
DESHNOK - DSO
KAPTANGANJ JN - CPJ
NAGDA JN - NAD
SEMAPUR - SMO
ASAFPUR - AFR
DEVAKOTTAI ROAD - DKO
KAPURTHALA - KXH
NAGER COIL TOWN - NJT
SENCHOA JN - SCE
ASALPUR JOBNER - JOB
DEVBALODA CHRDA - DBEC
KARAD - KRD
NAGERCOIL JN - NCJ
SENDRA - SEU
ASANSOL JN - ASN
DEVLALI - DVL
KARAGOLA ROAD - CRR
NAGINA - NGG
SENGOTTAI - SCT
ASAOTI - AST
DEWANGANJ - DWG
KARAIKAL - KIK
NAGIREDDIPALLI - NRDP
SEOHARA - SEO
ASARVA JN - ASV
DEWAS - DWX
KARAIKKUDI JN - KKDI
NAGORE - NCR
SEORAPHULI - SHE
ASHAPURA GOMAT - AQG
DHABAN - DABN
KARAILA ROAD JN - KRLR
NAGPUR - NGP
SERAM - SEM
ASHOK NAGAR - ASKN
DHACA CANTT - DHCA
KARAJGI - KJG
NAGPUR ROAD - NPRD
SERAMPORE - SRP
ASIFABAD ROAD - ASAF
DHALGAON - DLGN
KARAK BEL - KKB
NAHARKATIYA - NHK
SEVAGRAM - SEGM
ASLANA - ANA
DHAMALGAON - DMGN
KARAMNASA - KMS
NAIHATI JN - NH
SEWAPURI - SWPR
ASRANADA - AAS
DHAMANGAON - DMN
KARANJGAON - KAJG
NAILA - NIA
SEYDUNGANALLUR - SDNR
ATARI - ATT
DHAMARA GHAT - DHT
KARAUTA - KWO
NAINI - NYN
SHADNAGAR - SHNR
ATARRA - ATE
DHAMPUR - DPR
KARBIGWAN - KBN
NAINPUR JN - NIR
SHAHABAD - SDB
ATHMAL GOLA - ATL
DHANAURI - DNRE
KARCHHA - KDHA
NAJIBABAD JN - NBD
SHAHBAD MARKNDA - SHDM
ATTABIRA - ATS
DHANBAD JN - DHN
KARELI - KY
NAKODAR JN - NRO
SHAHDOL - SDL
ATTILI - AL
DHANDARI KALAN - DDL
KARENGI - KEG
NAKSALBARI - NAK
SHAHGANJ JN - SHG
ATTUR - ATU
DHANERA - DQN
KAREPALLI - KRA
NALANDA - NLD
SHAHJEHANPUR - SPN
AUNG - AUNG
DHANMANDAL - DNM
KARGI ROAD - KGB
NALBARI - NLV
SHAHPUR PATOREE - SPP
AUNRIHAR JN - ARJ
DHANSU - DNX
KARHIYA BHADELI - KYX
NALGONDA - NLDA
SHAJAPUR - SFY
AURANGABAD - AWB
DHANUVACHAPURAM - DAVM
KARIMGANJ JN - KXJ
NALHATI JN - NHT
SHAKTI NAGAR - SKTN
AVADI - AVD
DHARANGAON - DXG
KARIMNAGAR - KRMR
NALWAR - NW
SHAKURBASTI - SSB
AWATARNAGAR - ATNR
DHARHARA - DRH
KARIMUDDIN PUR - KMDR
NAMBURU - NBR
SHALIMAR - SHM
AYODHYA - AY
DHARIWAL - DHW
KARISATH - KRS
NAMKON - NKM
SHAM CHAURASI - SCQ
AYODHYAPATTANAM - APN
DHARMABAD - DAB
KARJAT - KJT
NAMLI - NLI
SHAMGARH - SGZ
AZAMGARH - AMH
DHARMANAGAR - DMR
KARKELI - KKI
NAMRUP - NAM
SHAMLI - SMQL
AZAMNAGAR ROAD - AZR
DHARMAPURI - DPJ
KARKHELI - KEK
NAMTIALI - NMT
SHANKARGARH - SRJ
AZIMGANJ JN - AZ
DHARMAVARAM JN - DMM
KARMALI - KRMI
NANA - NANA
SHANKARPALLI - SKP
B CEMENT NAGAR - BEY
DHARMPUR HMCHL - DMP
KARNA - KAR
NANDALUR - NRE
SHEDBAL - SED
BABATPUR - BTP
DHARWAR - DWR
KARNAL - KUN
NANDGANJ - NDJ
SHEGAON - SEG
BABHNAN - BV
DHASA JN - DAS
KARONJI - KJZ
NANDGAON - NGN
SHEIKPURA - SHK
BABINA - BAB
DHAULPUR - DHO
KARPURIGRAM - KPGM
NANDGAON ROAD - NAN
SHEOPRASADNAGER - SPDR
BABRALA - BBA
DHAUNI - DWLE
KARTARPUR - KRE
NANDURA - NN
SHERTALAI - SRTL
BABUPETH - BUPH
DHAURA - DUA
KARUNAGAPALLI - KPY
NANDURBAR - NDB
SHIKARA - SKY
BACHHRAWAN - BCN
DHEENA - DHA
KARUR - KRR
NANDYAL - NDL
SHIKOHABAD JN - SKB
BACHWARA JN - BCA
DHEMAJI - DMC
KARWAR - KAWR
NANGAL DAM - NLDM
SHIMOGA - SME
BADABANDHA - BDBA
DHENKANAL - DNKL
KASARA - KSRA
NANGLOI - NNO
SHIMOGA TOWN - SMET
BADAMI - BDM
DHILWAN - DIW
KASARAGOD - KGQ
NANGUNERI - NNN
SHIRRAVDE - SIW
BADARPUR JN - BPB
DHIRERA - DHRR
KASGANJ - KSJ
NANPARA JN - NNP
SHIRUD - SHF
BADARWAS - BDWS
DHODHAR - DOD
KASHI - KEI
NAPASAR - NPS
SHIUPUR - SOP
BADHWA BARA - BDWA
DHODRA MOHAR - DOH
KASHI CHAK - KSC
NARAINA - NRI
SHIVAJI BRIDGE - CSB
BADLA GHAT - BHB
DHOLA JN - DLJ
KASHIPUR - KPV
NARANGI - NNGE
SHIVAJINAGAR - SVJR
BADLAPUR - BUD
DHOLI - DOL
KASIMPUR - KCJ
NARANJIPUR - NRGR
SHIVANARAYANPUR - SVRP
BADLI - BHD
DHONE - DHNE
KASTHA - KSTA
NARANPUR - NANR
SHIVNAGAR - SHNG
BADMAL - BUDM
DHORAJI - DJI
KATAKHAL JN - KTX
NARASAPUR - NS
SHIVPURI - SVPI
BADNAPUR - BDU
DHRANGDHRA - DHG
KATAREAH - KTRH
NARASARAOPET - NRT
SHIVRAMPUR - SWC
BADNERA JN - BD
DHUBRI - DBB
KATHARA ROAD - KTRR
NARASINGAPALLI - NASP
SHOGHI - SGS
BADODAR - BDDR
DHULE - DHI
KATHGODAM - KGM
NARAYANPET ROAD - NRPD
SHOLAVANDAN - SDN
BADSHAHNAGAR - BNZ
DHULIAN GANGA - DGLE
KATHLEEGHAT - KEJ
NARAYANPUR - NNR
SHOLINGHUR - SHU
BADSHAHPUR - BSE
DHULKOT - DKT
KATHUA - KTHU
NARAYNPUR ANANT - NRPA
SHORANUR JN - SRR
BADULIPAR - BLPR
DHUPGURI - DQG
KATIHAR JN - KIR
NARELA - NUR
SHRI GANGANAGAR - SGNR
BAGAHA - BUG
DHURI JN - DUI
KATNI - KTE
NARIAOLI - NOI
SHRI MADHOPUR - SMPR
BAGALKOT - BGK
DHURWASIN - DRSN
KATNI MURWARA - KMZ
NARKATIAGANJ JN - NKE
SHRI MAHABIRJI - SMBJ
BAGBAHRA - BGBR
DIBRUGARH - DBRG
KATOL - KATL
NARKHER - NRKR
SHRIBDRYA LATHI - SBLT
BAGDIHI - BEH
DIBRUGARH TOWN - DBRT
KATORA - KTO
NARNAUL - NNL
SHRIDHAM - SRID
BAGETAR - BF
DIDWANA - DIA
KATPADI JN - KPD
NARSINGHPUR - NU
SHRIGONDA ROAD - SGND
BAGEVADI RD - BSRX
DIGARU - DGU
KATRA - KEA
NARSIPATNAM RD - NRP
SHRIRAJNAGAR - SAGR
BAGHAULI - BGH
DIGBOI - DBY
KATRASGARH - KTH
NARWANA JN - NRW
SHRIRANGAPATNA - S
BAGHDOGRA - BORA
DIGHA FLAG STN - DGHA
KATWA - KWAE
NASIK ROAD - NK
SHUJAATPUR - SJT
BAGHORA - BJQ
DIGHWARA - DGA
KAURHA - KUF
NASIRABAD - NSD
SHUJALPUR - SJP
BAGHUAPAL - BGPL
DIHAKHO - DKE
KAVALI - KVZ
NASRALA - NAS
SHYAMPURI - SMPA
BAGNAN - BZN
DILAWARNAGAR - DIL
KAVATHE MAHANKL - KVK
NATHNAGAR - NAT
SIBSAGAR TOWN - SRTN
BAGRA TAWA - BGTA
DILDARNAGAR JN - DLN
KAVUTARAM - KVM
NAUGACHIA - NNA
SIDDHPUR - SID
BAHADUR SINGH W - BSS
DIMAPUR - DMV
KAYALPATTINAM - KZY
NAUPADA JN - NWP
SIGADAM - SGDM
BAHADURGARH - BGZ
DINA NAGAR - DNN
KAYANKULAM JN - KYJ
NAUTANWA - NTV
SIHAPAR - SIPR
BAHJOI - BJ
DINDIGUL JN - DG
KAYAR - KAYR
NAVAGADH - NUD
SIHO - SIHO
BAHRAICH - BRK
DIPHU - DPU
KAZHAKUTTAM - KZK
NAVAPUR - NWU
SIHOR GUJARAT - SOJN
BAIDYANATHDHAM - BDME
DISA - DISA
KAZIPET JN - KZJ
NAVSARI - NVS
SIHORA ROAD - SHR
BAIGUDA - BGUA
DITOKCHERRA - DTC
KCG FALAKNUMA - FM
NAWA CITY - NAC
SIKANDRA RAO - SKA
BAIHATOLA - BATL
DIVINE NAGAR - DINR
KECKHI - KCKI
NAWABGANJ GONDA - NGB
SIKAR JN - SIKR
BAIKUNTHPUR RD - BRH
DIYODAR - DEOR
KEDGAON - KDG
NAWADAH - NWD
SIKARPAI - SKPI
BAIRAGARH - BIH
DODBALLAPUR - DBU
KEM - KEM
NAWAGAON - NVG
SILAO - SILO
BAITARANI ROAD - BTV
DOIWALA - DWO
KENDPOSI - KNPS
NAWANDGI - NAW
SILAPATHAR - SPTR
BAJUD - BJUD
DOMINGARH - DMG
KENDRAPARA ROAD - KNPR
NAWAPARA ROAD - NPD
SILAUT - SLT
BAJVA - BJW
DONAKONDA - DKD
KENDUJHARGARH - KDJR
NAYA NANGAL - NNGL
SILCHAR - SCL
BAKHLETA - BQQ
DONDAICHA - DDE
KENGERI - KGI
NAYADUPETA - NYP
SILGHAT TOWN - SHTT
BAKHTIYARPUR JN - BKP
DONGARGARH - DGG
KESAMUDRAM - KDM
NAYAGAON - NYO
SILIGURI JN - SGUJ
BALAGHAT JN - BTC
DORAHA - DOA
KESHOD - KSD
NAYAGARH - NYG
SILLI - SLF
BALAMU JN - BLM
DORNAKAL JN - DKJ
KESHORAI PATAN - KPTN
NAZARETH - NZT
SIMALUGURI JN - SLGR
BALANGIR - BLGR
DUBAHA - DUBH
KESINGA - KSNG
NAZIRGANJ - NAZJ
SIMARIA - SAE
BALASORE - BLS
DUBRAJPUR - DUJ
KEUTGUDA - KTGA
NEKONDA - NKD
SIMBHOOLI - SMBL
BALAWALI - BLW
DUDDHINAGAR - DXN
KHACHROD - KUH
NELLORE - NLR
SIMHACHALAM - SCM
BALHARSHAH - BPQ
DUDHANI - DUD
KHADA - KZA
NEORA - NEO
SIMLA - SML
BALLABGARH - BVH
DUGGIRALA - DIG
KHADKI - KK
NEPANAGAR - NPNR
SIMULTALA - STL
BALLIA - BUI
DULIAJAN - DJG
KHAGA - KGA
NERAL - NRL
SINDHUDURG - SNDD
BALOD - BXA
DULLAHAPUR - DLR
KHAGARIA JN - KGG
NERGUNDI - NRG
SINDI - SNI
BALOTRA JN - BLT
DUMKA - DUMK
KHAGRAGHAT ROAD - KGLE
NEW ALIPURDAUR - NOQ
SINDKHEDA - SNK
BALPUR HALT - BPRH
DUMRAON - DURE
KHAIRAR JN - KID
NEW AMRAVAT - NAVI
SINDRIBLOCK HUT - SDBH
BALUGAN - BALU
DUMRI BIHAR - DMBR
KHAIRTHAL - KRH
NEW BONGAIGAON - NBQ
SINGAPURAM ROAD - SPRD
BALURGHAT - BLGT
DUMRI HALT - DMRX
KHAJAULI - KJI
NEW COOCH BEHAR - NCB
SINGARAM - SGRM
BAMHRAULI - BMU
DUMURIPUT - DMRT
KHAJURAHO - KURJ
NEW DELHI - NDLS
SINGARAYAKONDA - SKM
BAMLA - BMLL
DUNDI - DDCE
KHALARI - KLRE
NEW FARAKKA JN - NFK
SINGHPUR - SNGP
BAMNIA - BMI
DUNGARPUR - DNRP
KHALILABAD - KLD
NEW GUNTUR - NGNT
SINGRAULI - SGRL
BAMRA - BMB
DUNGRI - DGI
KHALILPUR - KIP
NEW JALPAIGURI - NJP
SINI JN - SINI
BANAHI - BYN
DURAUNDHA JN - DDA
KHALISPUR - KSF
NEW KATNI JN - NKJ
SIRARI - SRY
BANAPURA - BPF
DURG - DURG
KHALLIKOT - KIT
NEW MAL JN - NMZ
SIRATHU - SRO
BANAR - BNO
DURGAPUR - DGR
KHAMBHALIYA - KMBL
NEW MAYNAGURI - NMX
SIRHIND JN - SIR
BANASWADI - BAND
DURGAPURA - DPA
KHAMMAM - KMT
NEW MISAMARI - NMM
SIRKAZHI - SY
BANBASA - BNSA
DURGAUTI - DGO
KHANA JN - KAN
NEW TINSUKIA JN - NTSK
SIROHI ROAD - SOH
BANDA JN - BNDA
DUSI - DUSI
KHANAPUR - KNP
NEYYATTINKARA - NYY
SIRPUR KAGAZNGR - SKZR
BANDAKPUR - BNU
DUVVADA - DVD
KHANDALA - KAD
NIDADAVOLU JN - NDD
SIRPUR TOWN - SRUR
BANDANWARA - BDW
DWARAPUDI - DWP
KHANDWA - KNW
NIDAMANGALAM - NMJ
SIRSA - SSA
BANDARKHAL - BXK
DWARKA - DWK
KHANNA - KNN
NIDUBROLU - NDO
SIRSAUL - SSL
BANDEL JN - BDC
EKAMBARAKUPPAM - EKM
KHANNA BANJARI - KHBJ
NIGAURA - NIQ
SISVINHALLI - SVHE
BANDIKUI JN - BKI
EKANGARSARAI - EKR
KHARAGPUR JN - KGP
NIGOHAN - NHN
SISWA BAZAR - SBZ
BANDRA TERMINUS - BDTS
EKCHARI - EKC
KHARAK - KHRK
NIHALGARH - NHH
SITABINJ - STBJ
BANGALORE CANT - BNC
EKLAKHI - EKI
KHARIA KHANGARH - KXG
NILAKANTHESWAR - NKW
SITAFAL MANDI - STPD
BANGALORE CY JN - SBC
EKMA - EKMA
KHARIAR ROAD - KRAR
NILAMBUR ROAD - NIL
SITALPUR - STLR
BANGALORE EAST - BNCE
ELIMALA - ELM
KHARSALIYA - KRSA
NILESHWAR - NLE
SITAMARHI - SMI
BANGARAPET - BWT
ELLAMANCHILI - YLM
KHARSIA - KHS
NILOKHERI - NLKR
SITAPUR - STP
BANGRIPOSI - BGY
ELURU - EE
KHARWA CHANDA - KRCD
NIM KA THANA - NMK
SITAPUR CANT - SCC
BANGROD - BOD
ERANAKULAM JN - ERS
KHATAULI - KAT
NIMACH - NMH
SITAPUR CITY - SPC
BANI - BANI
ERANIEL - ERL
KHATIMA - KHMA
NIMBAHERA - NBH
SITARAMPUR - STN
BANKA - BAKA
ERNAKULAM TOWN - ERN
KHATIPURA - KWP
NIMBAL - NBL
SIURI - SURI
BANKA GHAT - BKG
ERODE JN - ED
KHATU - KHTU
NIMBHORA - NB
SIVAGANGA - SVGA
BANKATA - BTK
ERRUPALEM - YP
KHED - KHED
NIMTITA - NILE
SIVAKASI - SVKS
BANKHEDI - BKH
ETAWAH - ETW
KHEDULI - KQW
NINGALA JN - NGA
SIWAITH - SWE
BANKURA - BQA
ETTAPUR ROAD - ETP
KHERI SALWA - KSW
NIPHAD - NR
SIWAN JN - SV
BANMOR - BAO
ETTUMANUR - ETM
KHERLI - KL
NIRA - NIRA
SLEEMANABAD RD - SBD
BANO - BANO
FAIZABAD JN - FD
KHETA SARAI - KS
NIRAKARPUR - NKP
SNARAYAN CHAPIA - SNC
BANSIPUR - BSQP
FAIZULLAPUR - FYZ
KHIRKIYA - KKN
NISUI - NSU
SOHAGPUR - SGP
BANSPANI - BSPX
FAKIRAGRAM JN - FKM
KHIRSADOH JN - KUX
NIVARI - NEW
SOHWAL - SLW
BANSTHALI NIWAI - BNLW
FALAKATA - FLK
KHODIYAR - KHD
NIWAR - NWR
SOJAT ROAD - SOD
BANTAWALA - BNTL
FALNA - FA
KHODRI - KOI
NIWAS ROAD - NWB
SOLAN - SOL
BANTHRA - BTRA
FARAH TOWN - FHT
KHOIRABARI - KBY
NIZAMABAD - NZB
SOLAPUR JN - SUR
BAPATLA - BPP
FARIDABAD - FDB
KHONGSARA - KGS
NOAMUNDI - NOMD
SOMESAR - SOS
BAPUDM MOTIHARI - MKI
FARIDABAD NW TN - FDN
KHORASON ROAD - KRND
NOKHA - NOK
SOMNATH - SMNH
BAPUDM MOTIHARI - BMKI
FARIDKOT - FDK
KHUDIRAM B PUSA - KRBP
NORLA ROAD - NRLR
SOMPETA - SPT
BARA JAMDA - BJMD
FARRUKHABAD - FBD
KHUMTAI - KUTI
NORTH LAKHIMPUR - NLP
SON NAGAR - SEB
BARABANKI JN - BBK
FATEH SINGHPURA - FSP
KHURAI - KYE
NOWROZABAD - NRZB
SONADA - SAD
BARABHUM - BBM
FATEHGARH - FGR
KHURDA ROAD JN - KUR
NRYNPUR TATWAR - NNW
SONAGIR - SOR
BARABIL - BBN
FATEHGARH SAHIB - FGSB
KHURDPUR - KUPR
NSC BOSE J GOMO - GMO
SONALLI - SI
BARADWAR - BUA
FATEHNAGAR - FAN
KHURHAND - KHU
NUAGAON - NXN
SONBARSA KCHERI - SBM
BARAGOPAL - BAGL
FATEHPUR - FTP
KHURIAL - KWE
NUJELLA - NUJ
SONDAD - SNV
BARAHAT - BHLE
FATEHPUR SIKRI - FTS
KHURJA CITY - KJY
NUMALIGARH - NMGY
SONEGAON - SNN
BARAIGRAM JN - BRGM
FATWA - FUT
KHURJA JN - KRJ
NUNKHAR - NRA
SONGADH - SGD
BARAKAR - BRR
FEROK - FK
KHUSROPUR - KOO
NURMAHAL - NRM
SONI - SONI
BARAL - BARL
FIROZABAD - FZD
KILA KADAIYAM - KKY
NUZVID - NZD
SONIPAT - SNP
BARAN - BAZ
FIROZPUR CANT - FZR
KILA RAIPUR - QRP
OBAIDULLA GANJ - ODG
SONPUR JN - SEE
BARANG - BRAG
FORBESGANJ - FBG
KIM - KIM
OBRA DAM - OBR
SONTALAI - SQL
BARARA - RAA
FURKATING JN - FKG
KINWAT - KNVT
OBULAVARIPALLI - OBVP
SONUA - SWR
BARAUNI JN - BJU
FURSATGANJ - FTG
KIRAOLI - KLB
ODELA - OEA
SORBHOG JN - SBE
BARAUT - BTU
G.RAMACHANDRAPU - GRCP
KIRATGARH - KRTH
OKHA - OKHA
SORO - SORO
BARBATPUR - BBTR
GACHHIPURA - GCH
KIRATPUR SAHIB - KART
OKHLA - OKA
SORON - SRNK
BARCHI ROAD - BCRD
GADAG JN - GDG
KIRIHRAPUR - KER
OLD MALDA - OMLF
SRI DUNGARGARH - SDGH
BARDDHAMAN JN - BWN
GADARWARA - GAR
KIRLOSKARVADI - KOV
OMALUR - OML
SRI KALAHASTI - KHT
BARDOLI - BIY
GADWAL - GWD
KISHANGANJ - KNE
ONDAGRAM - ODM
SRIKAKULAM ROAD - CHE
BAREILLY - BRY
GAHMAR - GMR
KISHANGARH - KSG
ONGOLE - OGL
SRIKRISHN NAGAR - SKN
BAREILLY - BE
GAJRAULA JN - GJL
KISHANPUR - KSP
ORAI - ORAI
SRIRAMNAGAR - SRNR
BAREILLY CITY - BC
GALGALIA - GAGA
KIUL JN - KIUL
ORGA - ORGA
SRIRANGAM - SRGM
BAREJADI - BJD
GALUDIH - GUD
KOCHUVELI - KCVL
OSIYAN - OSN
SRIVAIKUNTAM - SVV
BARELIPUR - BQM
GAMHARIA - GMH
KODAIKANAL ROAD - KQN
OTTAPPALAM - OTP
SRIVILLIPUTTUR - SVPR
BARETA - BRZ
GANAGAPUR ROAD - GUR
KODERMA - KQR
PACHHAPUR - PCH
SUBEDARGANJ - SFG
BARETH - BET
GANAUR - GNU
KODIYAR MANDIR - KDMR
PACHOR ROAD - PFR
SUBRAHMANYA ROA - SBHR
BARGARH - BRG
GANDHIDHAM BG - GIMB
KODUMUDI - KMD
PACHORA JN - PC
SUBZI MANDI - SZM
BARGARH ROAD - BRGA
GANDHINAGAR CAP - GNC
KODURU - KOU
PADADHARI - PDH
SUDAMDIH - SDMD
BARGAWAN - BRGW
GANDHINAGAR JPR - GADJ
KOELWAR - KWR
PADAMPUR - PDF
SUDHANI - SUD
BARGI - BUQ
GANESHGANJ - GAJ
KOIRIPUR - KEPR
PADUBIDRI - PDD
SUDSAR - SDF
BARH - BARH
GANGADHARPUR - GNGD
KOKRAJHAR - KOJ
PAHARPUR - PRP
SUHSARAI - SOW
BARHARWA JN - BHW
GANGAGANJ - GANG
KOLARAS - KLRS
PAKALA JN - PAK
SUISA - SSIA
BARHIYA - BRYA
GANGAKHER - GNH
KOLKATA - KOAA
PAKUR - PKR
SUJANGARH - SUJH
BARHNI - BNY
GANGAPUR CITY - GGC
KOLLAM JN - QLN
PALACHAURI - PCLI
SUJANPUR - SJNP
BARI BRAHMAN - BBMN
GANGARAMPUR - GRMP
KOLLIKHUTAHA - KKTA
PALAKKAD - PGT
SUKINDA ROAD - SKND
BARIARPUR - BUP
GANGIWARA - GNW
KOLNUR - KOLR
PALAKKODU - PCV
SUKRITIPUR - SQF
BARIPADA - BPO
GANGRAR - GGR
KONDAPALLI - KI
PALAKOLLU - PKO
SULGARE - SGRE
BARKA KANA - BRKA
GANGSAR JAITU - GJUT
KONDAPURAM - KDP
PALAM - PM
SULLURUPETA - SPE
BARKHERA - BKA
GANJ BASODA - BAQ
KOPARGAON - KPG
PALANPUR JN - PNU
SULTANGANJ - SGG
BARKISALALYA - BSYA
GANJ DUNDWARA - GWA
KOPARIA - KFA
PALASA - PSA
SULTANPUR - SLN
BARKUR - BKJ
GANJAM - GAM
KOPPAL - KBL
PALEJ - PLJ
SULTANPUR LODI - SQR
BARLAI - BLAX
GARH JAIPUR - GUG
KORAI HALT - KRIH
PALGHAR - PLG
SUMMER HILL - SHZ
BARMER - BME
GARHBETA - GBA
KORAPUT - KRPU
PALGHAT TOWN - PGTN
SUMRERI - SMRR
BARNALA - BNN
GARHI HARSARU - GHH
KORBA - KRBA
PALI MARWAR - PMY
SUNAM - SFM
BAROG - BOF
GARHI MANIKPUR - GRMR
KOREGAON - KRG
PALIA KALAN - PLK
SURAIMANPUR - SIP
BARPALI - BRPL
GARHMUKTESAR - GMS
KOSAMBA JN - KSB
PALLIYADI - PYD
SURAJPUR ROAD - SJQ
BARPATHAR - BXP
GARHWA - GHQ
KOSGI - KO
PALWAL - PWL
SURAT - ST
BARPETA ROAD - BPRD
GARIVIDI - GVI
KOSI KALAN - KSV
PAMAN - PMN
SURATGARH JN - SOG
BARRACKPORE - BP
GARLA - GLA
KOT KAPURA - KKP
PAMBAN JN - PBM
SURATHKAL - SL
BARRAJPUR - BJR
GAROT - GOH
KOTA JN - KOTA
PANAGARH - PAN
SURENDRANAGAR - SUNR
BARSALI - BYS
GARPOS - GPH
KOTABOMMALI - KBM
PANCH PIPILA - PCN
SURENDRANAGAR G - SRGT
BARSI TOWN - BTW
GARWA ROAD - GHD
KOTALPUKUR - KLP
PANCHGRAM - PNGM
SURGAON BANJARI - SGBJ
BARSOI JN - BOE
GAURA - GRX
KOTAPAR ROAD - KPRR
PANDABESWAR - PAW
SURIAWAN - SAW
BARSOLA - BZO
GAURI BAZAR - GB
KOTDWARA - KTW
PANDAUL - PDW
SUWASRA - SVA
BARUA BAMUNGAON - BBGN
GAURIBIDANUR - GBD
KOTHARI ROAD - KTHD
PANDAVAPURA - PANP
SWARUPGANJ - SRPJ
BARUD - BRUD
GAURIGANJ - GNG
KOTIKULAM - KQK
PANDHARPUR - PVR
TADAKALPUDI - TPY
BARWA SAGAR - BWR
GAUSHALA - GWS
KOTLI KALAN - KTKL
PANDHURNA - PAR
TADALI - TAE
BARWADIH JN - BRWD
GAUTAMSTHAN - GTST
KOTMA - KTMA
PANELI MOTI - PLM
TADEPALLIGUDEM - TDD
BARWALA - BXC
GAYA JN - GAYA
KOTMI SONAN HLT - KTSH
PANGAON - PNF
TADIPATRI - TU
BASAI - BZY
GAZOLE - GZO
KOTSHILA - KSX
PANIAHWA - PNYA
TADWAL - TVL
BASANTAPUR - BSTP
GETOR JAGATPURA - GTJT
KOTTAPALLI - KYOP
PANIPAT JN - PNP
TAHSIL FATEHPUR - TSF
BASAR - BSX
GEVRA ROAD - GAD
KOTTAVALASA - KTV
PANKI - PNK
TAIABPUR - TBR
BASBARI - BSI
GHAGWAL - GHGL
KOTTAYAM - KTYM
PANOLI - PAO
TAKARI - TKR
BASHARATGANJ - BTG
GHANAULI - GANL
KOVILPATTI - CVP
PANPOSH - PPO
TAKIA - TQA
BASMAT - BMF
GHANPUR - GNP
KOVVUR - KVR
PANRUTI - PRT
TAKU - TAKU
BASNI - BANE
GHARAUNDA - GRA
KOZHIKODE - CLT
PANSKURA - PKU
TALAKHAJURI - TLKH
BASSI - BAI
GHATAMPUR - GTM
KRISHANRAJANAGA - KRNR
PANVEL - PNVL
TALBAHAT - TBT
BASSI PATHANAM - BSPN
GHATERA - GEA
KRISHNA - KSN
PAPANASAM - PML
TALCHER - TLHR
BASTA - BTS
GHATPRABHA - GPB
KRISHNA CANAL - KCC
PARADIP - PRDP
TALCHER ROAD - TLHD
BASTI - BST
GHATSILA - GTS
KRISHNA CH PURA - KCV
PARADOL - PRDL
TALCHHAPAR - TLC
BASUGAON - BSGN
GHAZIABAD - GZB
KRISHNARAJAPURM - KJM
PARAIYA - PRY
TALEGAON - TGN
BASUKINATH - BSKH
GHAZIPUR CITY - GCT
KRISHNASHILLA - KRSL
PARAMAKKUDI - PMK
TALGUPPA - TLGP
BASWA - BU
GHOGA - GGA
KRISHNGR CTY JN - KNJ
PARAS - PS
TALJHARI - TLJ
BATALA JN - BAT
GHOKSADANGA - GDX
KUCHAMAN CITY - KMNC
PARASHSHALA - PASA
TALVADYA - TLV
BAWAL - BWL
GHOLVAD - GVD
KUCHMAN - KCA
PARASIA - PUX
TALWANDI - TWB
BAYANA JN - BXN
GHONSOR - GNS
KUDACHI - KUD
PARASNATH - PNME
TAMBARAM - TBM
BAYTU - BUT
GHORADONGRI - GDYA
KUDAL - KUDL
PARAVUR - PVU
TAMLUK - TMZ
BAZARSAU - BZLE
GHORPURI - GPR
KUDALNAGAR - KON
PARBATI - PRB
TANAKPUR - TPU
BEAS - BEAS
GHUGHULI - GH
KUDRA - KTQ
PARBHANI JN - PBN
TANDA URMAR - TDO
BEAWAR - BER
GHUM - GHUM
KUHURI - KUU
PARDI - PAD
TANDUR - TDU
BEGAMPET - BMT
GHUNGHUTI - GGT
KULEM - QLM
PAREWADI - PRWD
TANGIRIAPAL - TGRL
BEGU SARAI - BGS
GHUTKU - GTK
KULHARIA - KUA
PARISAL - PSL
TANGLA - TNL
BEHTAGOKUL - BEG
GIDDALUR - GID
KULITALAI - KLT
PARLI VAIJNATH - PRLI
TANGRA - TRA
BEKAL FORT - BFR
GIDDARBAHA - GDB
KULITTHURAI - KZT
PARMANANDPUR - PMU
TANGUTURU - TNR
BELA - BELA
GIDHAUR - GHR
KULITTURAI WEST - KZTW
PARPANANGADI - PGI
TANKUPPA - TKN
BELA TAL - BTX
GILL - GILL
KULPAHAR - KLAR
PARSABAD - PSB
TANUKU - TNKU
BELAKOBA - BLK
GIRIDIH - GRD
KULTI - ULT
PARSIPUR - PRF
TANUR - TA
BELAMPALLI - BPA
GIRIMAIDAN - GMDN
KUMARDUBI - KMME
PARSODA - PSD
TAPA - TAPA
BELAPUR - BAP
GIRWAR - GW
KUMARGHAT - KUGT
PARTAPGARH JN - PBH
TAPRI - TPZ
BELDA - BLDA
GOALDIH - GADH
KUMARHATTI - KMTI
PARTUR - PTU
TARADEVI - TVI
BELDANGA - BEB
GOALPARA TOWN - GLPT
KUMBAKONAM - KMU
PARVATIPURAM - PVP
TARANA ROAD - TAN
BELGAHNA - BIG
GODAVARI - GVN
KUMBHRAJ - KHRJ
PARVATIPURAM TN - PVPT
TARAORI - TRR
BELGAUM - BGM
GODHRA JN - GDA
KUMBLA - KMQ
PASRAHA - PSR
TARAPITH ROAD - TPF
BELHA - BYL
GOGAMUKH - GOM
KUMEDPUR - KDPR
PATARA - PTRE
TAREGNA - TEA
BELLARY JN - BAY
GOHAD ROAD - GOA
KUMTA - KT
PATAUDI ROAD - PTRD
TARGAON - TAZ
BELPAHAR - BPH
GOHPUR - GPZ
KUNDA HARNAMGNJ - KHNM
PATHANKOT - PTK
TARIGOPPULA - TGU
BELRAYAN - BXM
GOILKERA - GOL
KUNDAPURA - KUDA
PATHARDIH JN - PEH
TARIKERE JN - TKE
BELTHARA ROAD - BLTR
GOKAK ROAD - GKK
KUNEANGANJ - KVG
PATHARIA - PHA
TARLUPADU - TLU
BEOHARI - BEHR
GOKARNA ROAD - GOK
KUP - KUP
PATHARKANDI - PTKD
TARSARAI - TRS
BERCHHA - BCH
GOLA GOKARANATH - GK
KUPGAL - KGL
PATHRI - PRI
TARU - TR
BERHAMPORE CRT - BPC
GOLAGHAT - GLGT
KUPPAM - KPN
PATHSALA - PBL
TATANAGAR JN - TATA
BERMO - BRMO
GOLAKGANJ JN - GKJ
KURALI - KRLI
PATIALA - PTA
TATIBAHAR - TBH
BETAMCHERLA - BMH
GOLDINGANJ - GJH
KURDUVADI - KWV
PATNA JN - PNBE
TATISILWAI - TIS
BETHAMPURDI - BTPD
GOLLAPROLU - GLP
KURGUNTA - KQT
PATNA SAHEB - PNC
TEGHRA - TGA
BETHUADAHARI - BTY
GOMATI NAGAR - GTNR
KURICHEDU - KCD
PATRANGA - PTH
TEHTA - THA
BETNOTI - BTQ
GOMTA - GTT
KURNOOL TOWN - KRNT
PATRATU - PTRU
TELAM - TQM
BETTIAH - BTH
GONDA JN - GNAN
KURSELA - KUE
PATTAMBI - PTB
TELIAMURA - TLMR
BETUL - BZU
GONDA JN - GD
KURSEONG - KGN
PATTIKKAD - PKQ
TELO - TELO
BHABHAR - BAH
GONDAL - GDL
KURUKSHETRA JN - KKDE
PAVURCHUTRAM - PCM
TELTA - TETA
BHABUA ROAD - BBU
GONDIA JN - G
KURUMBUR - KZB
PAWAPURI ROAD - PQE
TENALI JN - TEL
BHACHAU BG - BCOB
GONDWANAVISAPUR - GNVR
KUSMHI - KHM
PAYAGPUR - PDR
TENGANMADA - TGQ
BHADAN - BDN
GONEANA - GNA
KUTRALAM - KTM
PAYANGADI - PAZ
TENKASI JN - TSI
BHADAURA - BWH
GOOTY - GY
KUTTIPPURAM - KTU
PAYYANUR - PAY
TETULMARI - TET
BHADOHI - BOY
GOP JAM - GOP
LABHA - LAV
PAYYOLI - PYOL
THAKURGANJ - TKG
BHADRACHALAM RD - BDCR
GORAKHNATH - GRKN
LACHHMANPUR - LMN
PEDAKAKANI HALT - PDKN
THAKURTOTA - TKH
BHADRAK - BHC
GORAKHPUR CANT - GKC
LACHYAN - LHN
PEDANA - PAV
THALASSERY - TLY
BHADRAVATI - BDVT
GORAKHPUR JN - GKP
LADHOWAL - LDW
PEDDAPALLI - PDPL
THALWARA - TLWA
BHAGA JN - VAA
GORAUL - GRL
LADNUN - LAU
PEDDAVADIAPUDI - PVD
THAN JN - THAN
BHAGALPUR - BGP
GORAYA - GRY
LAHERIA SARAI - LSI
PEDDEMPET - PPZ
THANA BIHPUR JN - THB
BHAGAT KI KOTHI - BGKT
GOSALPUR - GSPR
LAHLI - LHLL
PEMBARTI - PBP
THANDLA RD - THDR
BHAGWANGOLA - BQG
GOSHAINGANJ - GGJ
LAKADIYA - LKZ
PENCHARTHAL - PEC
THANE - TNA
BHAGWANPUR - BNR
GOSSAIGAON HAT - GOGH
LAKHERI - LKE
PENDEKALLU - PDL
THANJAVUR - TJ
BHAIROGANJ - BRU
GOTAN - GOTN
LAKHIMPUR - LMP
PENDRA ROAD - PND
THERUBALI - THV
BHAIRONGARH - BOG
GOVINDGARH - GVG
LAKHMINIA - LKN
PENNADAM - PNDM
THIRUVARUR JN - TVR
BHAKTI NAGAR - BKNG
GOVINDPUR ROAD - GBX
LAKHTAR - LTR
PENUKONDA - PKD
THIVIM - THVM
BHALKI - BHLK
GOVINDPURI - GOY
LAKSAR JN - LRJ
PEPPEGANJ - PJ
THRISUR - TCR
BHALUI - BFM
GOWDAVALLI - GWV
LAKSHMIBAI NGR - LMNR
PERALAM JN - PEM
THURIA - THUR
BHALUKA ROAD F - BKRD
GUDIVADA JN - GDV
LAKSWA - LXA
PERAMBUR - PER
TIHU - TIHU
BHALUKMARA - BLMR
GUDIYATTAM - GYM
LAL KUAN - LKU
PERNEM - PERN
TIKIRI - TKRI
BHALUMASKA - BLMK
GUDLAVALLERU - GVL
LALGANJ - LLJ
PETTAIVAYATALAI - PLI
TIKUNIA - TQN
BHANAPUR - BNP
GUDUR JN - GDR
LALGARH JN - LGH
PHAGWARA JN - PGW
TILAK BRIDGE - TKJ
BHANDAK - BUX
GUJHANDI - GJD
LALGOLA - LGL
PHALODI JN - PLCJ
TILARU - TIU
BHANDARA ROAD - BRD
GULABHGANJ - GLG
LALGOPALGANJ - LGO
PHAPHAMAU JN - PFM
TILAYA - TIA
BHANDARIDAH - BHME
GULABPURA - GBP
LALGUDI - LLI
PHAPHUND - PHD
TILDA - TLD
BHANVAD - BNVD
GULAOTHI - GLH
LALITPUR - LAR
PHEPHNA JN - PEP
TILHAR - TLH
BHANWAR TONK - BHTK
GULBARGA - GR
LALPUR JAM - LPJ
PHESAR - PES
TILONIYA - TL
BHARAT KUP - BTKP
GULDHAR - GUH
LAMBHUA - LBA
PHILLAUR JN - PHR
TIMARNI - TBN
BHARATPUR JN - BTE
GULEDAGUDDA RD - GED
LAMTA - LTA
PHULERA JN - FL
TIMMAPUR - TMX
BHARTHANA - BNT
GULZARBAGH - GZH
LANGTING - LGT
PHULPUR - PLP
TINDIVANAM - TMV
BHARUCH JN - BH
GUMANI - GMAN
LANJIGARH ROAD - LJR
PHULWARI SHARIF - PWS
TINPAHAR JN - TPH
BHARWA SUMERPUR - BSZ
GUMIA - GMIA
LANKA - LKA
PHULWARTANR - PLJE
TINSUKIA JN - TSK
BHARWARI - BRE
GUMMIDIPUNDI - GPD
LAR ROAD - LRD
PHUSRO - PUS
TIPKAI - TPK
BHATAPARA - BYT
GUNA - GUNA
LASALGAON - LS
PIDUGURALLA - PGRL
TIPTUR - TTR
BHATINDA JN - BTI
GUNDARDEHI - GDZ
LASUR - LSR
PILAMEDU - PLMD
TIRALDIH - TUL
BHATIYA - BHTA
GUNTAKAL JN - GTL
LATEHAR - LTHR
PILER - PIL
TIRCHRPALI FORT - TP
BHATKAL - BTJL
GUNTUR JN - GNT
LATHIDAD - LTD
PILI BANGAN - PGK
TIRORA - TRO
BHATNI JN - BTT
GURAMKHEDI - GMD
LATUR - LUR
PILIBHIT JN - PBE
TIRUCHCHIRAPALI - TPJ
BHATPAR RANI - BHTR
GURARU - GRRU
LATUR ROAD - LTRR
PILKHUA - PKW
TIRUCHENDUR - TCN
BHATTU - BHT
GURDASPUR - GSP
LAXMIPUR ROAD - LKMR
PIMPALKHUTI - PMKT
TIRUCHRPALI TWN - TPTN
BHAVANAGAR PARA - BVP
GURGAON - GGN
LEDO - LEDO
PIMPRI - PMP
TIRUKOILUR - TRK
BHAVANI NAGAR - BVNR
GURLA - GQL
LEHRA GAGA - LHA
PINDLAI - PQL
TIRUMANGALAM - TMQ
BHAVNAGAR TRMUS - BVC
GURNAY - GRN
LELIGUMA - LLGM
PINDRA ROAD - PDRD
TIRUNELVELI - TEN
BHAWANI MANDI - BWM
GURPA - GAP
LIDHORA KHURD - LDA
PINDRAI - PDE
TIRUNNAVAYA - TUA
BHAWANIPATNA - BWIP
GURRA - GRO
LILIYA MOTA - LMO
PIPALSANA - PLS
TIRUPADRIPULYUR - TDPR
BHAYAVADAR - BHY
GURSAHAIGANJ - GHJ
LIMBDI - LM
PIPAR ROAD JN - PPR
TIRUPARANKNDRM - TDN
BHEDIA - BDH
GURUVAYUR - GUV
LIMKHEDA - LMK
PIPARIYA - PPI
TIRUPATI - TPTY
BHERAGHAT - BRGT
GUSKARA - GKH
LINGAMPALLI - LPI
PIPLIA - PIP
TIRUPATTUR JN - TPT
BHIGWAN - BGVN
GUWAHATI - GHY
LINGTI - LNT
PIPLOD JN - PPD
TIRUPPUR - TUP
BHILAD - BLD
GWALIOR - GWL
LOHARU - LHU
PIPRAICH - PPC
TIRUR - TIR
BHILAI - BIA
GYANPUR ROAD - GYN
LOHIAN KHAS JN - LNK
PIPRAIGAON - PIA
TIRUTTANGAL - TTL
BHILAI PWR HS - BPHB
H NIZAMUDDIN - NZM
LOISINGHA - LSX
PIPRALA - PFL
TIRUTTANI - TRT
BHILAINAGAR - BQR
H SAHIB NANDED - NED
LOKMANYATILAK T - LTT
PIRAVAM ROAD - PVRD
TIRUVALLA - TRVL
BHILAVDI - BVQ
HABIBGANJ - HBJ
LONAND - LNN
PIRPAINTI - PPT
TIRUVALLUR - TRL
BHILDI - BLDI
HAFIZPUR - HZR
LONAVALA - LNL
PITAMBARPUR - PMR
TIRUVANNAMALAI - TNM
BHILWARA - BHL
HAFLONG HILL - HFG
LONDA JN - LD
PITHAPURAM - PAP
TIRUVERUMBUR - TRB
BHIMADOLU - BMD
HAIAGHAT - HYT
LORHA - LOA
PLASSEY - PLY
TISUA - TSA
BHIMASAR BG - BMSB
HAIDARNAGAR - HDN
LOWER HAFLONG - LFG
PMBAKVL SHANDY - PBKS
TITABAR - TTB
BHIMAVARAM JN - BVRM
HAIDERGARH - HGH
LUCKEESARAI JN - LKR
POCHARAM - PCZ
TITLAGARH - TIG
BHIMAVARAM TOWN - BVRT
HAJIPUR JN - HJP
LUCKNOW CITY - LC
PODANUR JN - PTJ
TIVARI - TIW
BHIMSEN - BZM
HALDAUR - HLDR
LUCKNOW NE - LJN
POKHRAYAN - PHN
TO DARJEELING - DJRZ
BHIND - BIX
HALDI ROAD - HLDD
LUCKNOW NR - LKO
POKLA - PKF
TODARPUR - TDP
BHIRA KHERI - BIK
HALDIA - HLZ
LUDHIANA JN - LDH
POKRAN - POK
TOHANA - TUN
BHITONI - BHTN
HALDIBARI - HDB
LUMDING JN - LMG
POLUR - PRL
TOMKA - TMKA
BHIWANDI ROAD - BIRD
HALDIPADA - HIP
LUNI JN - LUNI
PONDURU - PDU
TORANAGALLU - TNGL
BHIWANI - BNW
HALDWANI - HDW
LUNI RICHHA - LNR
PONMLAI GLD RCK - GOC
TORANG - TRAN
BHIWANI CITY - BNWC
HALVAD - HVD
LUNKARANSAR - LKS
PORBANDAR - PBR
TORI - TORI
BHOJIPURA JN - BPR
HAMIRA - HMR
LUSA - LUSA
PORJANPUR - PRNR
TRIKARPUR - TKQ
BHOJO - BOJ
HAMIRGARH - HMG
MACHELIPATNAM - MTM
POTHAHI - PFT
TRIUPUNITTURA - TRTR
BHOJUDIH JN - BJE
HAMIRPUR ROAD - HAR
MADAN MAHAL - MML
POTHIA - POT
TRIVANDRUM CNTL - TVC
BHOKAR - BOKR
HAMITONGANJ - HOJ
MADANAPALLE RD - MPL
POTKAPALLI - PTKP
TRIVANDRUM PETT - TVP
BHONGAON - BGQ
HANDIA KHAS - HDK
MADAR - MD
POTUL - POZ
TSUNDURU - TSR
BHONGIR - BG
HANSI - HNS
MADDIKERA - MKR
POWERKHEDA - PRKD
TUGLAKABAD - TKD
BHOPAL JN - BPL
HANUMANGARH JN - HMH
MADDUR - MAD
POWERPET - PRH
TULJAPUR - TGP
BHORAS BUDRUKH - BFJ
HAPA - HAPA
MADGAON - MAO
PRANTIK - PNE
TUMKUR - TK
BHUBANESWAR - BBS
HAPUR - HPU
MADHA - MA
PRAYAG - PRG
TUMSAR ROAD - TMR
BHUCHCHU - BCU
HARANGAJAO - HJO
MADHI - MID
PUDUCHERRY - PDY
TUNDLA JN - TDL
BHUGAON - BPK
HARANGUL - HGL
MADHIRA - MDR
PUDUKAD - PUK
TUNG - TUNG
BHUJ - BHUJ
HARCHANDPUR - HCP
MADHOPUR PUNJAB - MDPB
PUDUKKOTTAI - PDKT
TUNI - TUNI
BHULANPUR - BHLP
HARDA - HD
MADHOSINGH - MBS
PUGALUR - PGR
TURAVUR - TUVR
BHUPIA MAU - VPO
HARDAS BIGHA - HDE
MADHUBANI - MBI
PULGAON JN - PLO
TUTI MELUR - TME
BHURKUNDA - BHKD
HARDOI - HRI
MADHUPUR JN - MDP
PULLAMPET - PMT
TUTICORIN - TN
BHUSANDPUR - BSDP
HARDUA - HDU
MADURAI JN - MDU
PUNARAKH - PHK
TUVVUR - TUV
BHUSAVAL JN - BSL
HARICHANDANPUR - HCNR
MADURANTAKAM - MMK
PUNDHAG - PNW
TWINING GANJ - TWG
BIBINAGAR - BN
HARIDWAR JN - HW
MADWARANI - MWRN
PUNDI - PUN
UCHANA - UCA
BICHIA - BIC
HARIHAR - HRR
MAGHAR - MHH
PUNE JN - PUNE
UDAIPUR CITY - UDZ
BIDADI - BID
HARINAGAR - HIR
MAHADANAPURAM - MMH
PUNKUNNAM - PNQ
UDALGURI - ULG
BIDAR - BIDR
HARIPPAD - HAD
MAHAJAN - MHJ
PUNPUN - PPN
UDALKACHAR - UKR
BIDHAN NAGAR - BNXR
HARIPUR - HP
MAHANAGAR - MANG
PUNSIA - PNSA
UDGIR - UDGR
BIGHAPUR - BQP
HARISCHANDRPUR - HCR
MAHASAMUND - MSMD
PUNTAMBA - PB
UDHAMPUR - UHP
BIHAR SHARIF - BEHS
HARISHANKER RD - HSK
MAHBUBABAD - MABD
PURANPUR - PP
UDHNA JN - UDN
BIHARA - BHZ
HARMUTI - HMY
MAHBUBNAGAR - MBNR
PURI - PURI
UDUPI - UD
BIHIYA - BEA
HARNAUT - HRT
MAHE - MAHE
PURNA JN - PAU
UDVADA - UVD
BIHTA - BTA
HARPALGANJ - HRPG
MAHENDRAGARH - MHRG
PURNIA JN - PRNA
UGAR KHURD - UGR
BIJAINAGAR - BJNR
HARPALPUR - HPP
MAHES KHUNT - MSK
PURULIA JN - PRR
UGRASENPUR - URPR
BIJAPUR - BJP
HARRAD - HRV
MAHESANA JN - MSH
PUTTUR - PUT
UJALVAV - UJ
BIJAYSOTA - VST
HARRAWALA - HRW
MAHESHMUNDA - MMD
PWN KLAKNDER RD - PQN
UJHANI - UJH
BIJNI - BJF
HARRI - HRB
MAHIDPUR ROAD - MEP
QUILANDI - QLD
UJIARPUR - UJP
BIJNOR - BJO
HARSAULI - HSI
MAHMUDABAD AVDH - MMB
RADHANPUR - RDHP
UJJAIN JN - UJN
BIJOOR - BIJR
HASANPARTHI RD - HSP
MAHOBA - MBA
RADHIKAPUR - RDP
UKHRA - UKA
BIJURI - BJRI
HASANPUR ROAD - HPO
MAHUDA - MHQ
RAE BARELI JN - RBL
UKLANA - UKN
BIJWASAN - BWSN
HASIMARA - HSA
MAHUR - MXR
RAFIGANJ - RFJ
ULHASNAGAR - ULNR
BIKANER JN - BKN
HASSAN - HAS
MAHUVA JN - MHV
RAGAUL - RGU
ULLAL - ULL
BIKKAVOLU - BVL
HATHBANDH - HN
MAIBANG - MBG
RAGHAVAPURAM - RGPM
ULUBARIA - ULB
BIKRAM SHILA - BKSL
HATHIDAH JN - HTZ
MAIHAR - MYR
RAGHUNATHPALLI - RGP
UMAR TALI - UTA
BIKRAMPUR - BMR
HATHRAS CITY - HTC
MAILANI - MLN
RAGHUNATHPUR - RCTC
UMARIA - UMR
BILASPUR JN - BSP
HATHRAS JN - HRS
MAILONGDISA - MGX
RAGHUNATHPUR - RPR
UMBARGAM ROAD - UBR
BILASPUR ROAD - BLQR
HATIA - HTE
MAINPURI - MNQ
RAGHURAJ SINGH - RRS
UMDANAGAR - UR
BILDI - BILD
HATIKHALI - HTL
MAIRWA - MW
RAHAMA - RHMA
UMED - UMED
BILGA - BZG
HATKANAGALE - HTK
MAJBAT - MJBT
RAHIMABAD - RBD
UMRI - UMRI
BILHAR GHAT - BLG
HATPURAINI - HPLE
MAJHAGAWAN - MJG
RAHIMATPUR - RMP
UNA HIMACHAL - UHL
BILHAUR - BLU
HAVERI - HVR
MAJHOLA PAKARYA - MJZ
RAHURI - RRI
UNCHAHAR JN - UCR
BILIMORA JN - BIM
HAZARIBAGH RD - HZD
MAJHOWLIA - MJL
RAICHUR - RC
UNCHHERA - UHR
BILPUR - BLPU
HELEM - HML
MAJRI JN - MJRI
RAIGANJ - RGJ
UNDASA MADHAWPU - UDM
BILWAI - BWI
HIJILLI - HIJ
MAKHDUMPUR GAYA - MDE
RAIGARH - RIG
UNJALUR - URL
BINA JN - BINA
HILARA - HLX
MAKHU - MXH
RAIGIR - RAG
UNJHA - UJA
BINDKI ROAD - BKO
HILSA - HIL
MAKRANA JN - MKN
RAIKA BAGH - RKB
UNNAO JN - ON
BINNAGURI - BNV
HIMAYATNAGAR - HEM
MAKRONIA - MKRN
RAIMEHATPUR - MTPR
UNTARE ROAD - URD
BIRADHWAL - BDWL
HIMMATANA - HMI
MAKSI - MKC
RAIPUR JN - R
UPLETA - UA
BIRAPATTI - BRPT
HIMMATNAGAR - HMT
MAKUDI - MKDI
RAIRAKHOL - RAIR
UPPAL - OPL
BIRSINGHPUR - BRS
HINDAUN CITY - HAN
MAKUM JN - MJN
RAISI - RSI
UPPALA - UAA
BIRUR JN - RRB
HINDUPUR - HUP
MALAKHERA - MKH
RAIWALA - RWL
UREN - UREN
BISHNATHGANJ - BTJ
HINGANGHAT - HGT
MALAKPET KCG - MXT
RAJ GANGPUR - GP
URGA - URGA
BISHNUPUR - VSU
HINGOLI DECCAN - HNL
MALANCHA - MLNH
RAJ NANDGAON - RJN
URULI - URI
BISHRAMPUR - BSPR
HIRA NAGAR - HRNR
MALANPUR - MLAR
RAJA KA SAHASPR - RJK
USALAPUR - USL
BISRA - BZR
HIRAKUD - HKG
MALARNA - MLZ
RAJA KI MANDI - RKM
USMANABAD - UMD
BISSAMCUTTACK - BMCK
HIRDAGARH - HRG
MALDA TOWN - MLDT
RAJALDESAR - RJR
UTARLAI - UTL
BISUGIRSHARIF - BGSF
HIRNODA - HDA
MALERKOTLA - MET
RAJAMUNDRY - RJY
UTRAHTIA - UTR
BISWAN - BVN
HISAR - HSR
MALHARGARH - MLG
RAJANAGAR - RJA
UTTUKULI - UKL
BITRAGUNTA - BTTR
HODAL - HDL
MALHOUR - ML
RAJAPALAYAM - RJPM
VADAKARA - BDJ
BIYAVRA RAJGARH - BRRG
HOJAI - HJI
MALIHABAD - MLD
RAJAPUR ROAD - RAJP
VADGAON - VDN
BOBBILI - VBL
HOLE ALUR - HLAR
MALIPUR - MLPR
RAJGARH - RHG
VADLAMANNADU - VMD
BODHADI BUJRUG - BHBK
HOLE NARSIPUR - HLN
MALIYA HATINA - MLHA
RAJGHAT NARORA - RG
VADODARA JN - BRC
BODWAD - BDWD
HONNAVAR - HNA
MALIYA MIYANA - MALB
RAJGIR - RGD
VAIBHAVWADI RD - VBW
BOHALI - BHLI
HOSHANGABAD - HBD
MALKAJGIRI - MJF
RAJGRAM - RJG
VAIKOM - VARD
BOHANI - BNE
HOSHIARPUR - HSX
MALKAPUR - MKU
RAJKHARSAWAN JN - RKSN
VAILAPUZHA - VPZ
BOINDA - BONA
HOSPET JN - HPT
MALKAPUR ROAD - MALK
RAJKOT JN - RJT
VALAPATTANAM - VAPM
BOISAR - BOR
HOSUR - HSRA
MALKHAID ROAD - MQR
RAJMANE - RM
VALAPPADI G HLT - VGE
BOKAJAN - BXJ
HOTGI - HG
MALKHEDI - MAKR
RAJPURA JN - RPJ
VALIVADE - VV
BOKARO STL CITY - BKSC
HOWBADH JABLPUR - HBG
MALLANWALA KHAS - MWX
RAJULA JN - RLA
VALLIKUNNU - VLI
BOKARO THERMAL - BKRO
HOWRAH JN - HWH
MALLAPUR - MLP
RAKHA MINES - RHE
VALLIYUR - VLY
BOLARUM - BMO
HUBLI JN - UBL
MALLARPUR - MLV
RAM CHAURA ROAD - RMC
VALSAD - BL
BOLINNA DOABA - BLND
HYDERABAD DECAN - HYB
MALLESWARAM - MWM
RAM NAGAR J K - RMJK
VANCHIMANIYACHI - MEJ
BOLPUR S NIKTN - BHP
ICHAULI - ICL
MALLICKPUR HAT - MKRH
RAMAN - RMN
VANGAON - VGN
BOMMIDI - BQI
ICHCHPURAM - IPM
MALOUT - MOT
RAMANAGARAM - RMGM
VANIYAMBADI - VN
BONA KALU - BKL
IDAPLLI - IPL
MALSIAN SHAHKHT - MQS
RAMANATHAPURAM - RMD
VANIYAMBALAM - VNB
BONDAMUNDA - BNDM
IDGAH AGRA JN - IDH
MALUR - MLO
RAMANNAPET - RMNP
VAPI - VAPI
BONGAIGAON - BNGN
IGATPURI - IGP
MALWAN - MWH
RAMBHA - RBA
VARAHI - VRX
BORDHAL - BXY
IKKAR - IKK
MAMAN - MOM
RAMBHADDARPUR - RBZ
VARANASI CITY - BCY
BORDI - BIO
IKLEHRA - IKR
MAMBALAM - MBM
RAMDEVRA - RDRA
VARANASI JN - BSB
BORHAT - BFD
INDARA JN - IAA
MANAKSAR - MNSR
RAMESWARAM - RMM
VARANGAON - VNA
BORIDAND - BRND
INDARGARH - IDG
MANAMADURAI JN - MNM
RAMGANJ MANDI - RMA
VARKALA - VAK
BORIVALI - BVI
INDI ROAD - IDR
MANANPUR - MNP
RAMGARH CANT - RMT
VARTEJ - VTJ
BORVIHIR - BRVR
INDORE JN BG - INDB
MANANWALA - MOW
RAMGARHWA - RGH
VASAD JN - VDA
BOTAD JN - BTD
IRINJALAKUDA - IJK
MANAPARAI - MPA
RAMGUNDAM - RDM
VASAI ROAD - BSR
BRAHMAPUR - BAM
IRUGUR - IGU
MANAURI - MRE
RAMNA - RMF
VASCO DA GAMA - VSG
BRAJRAJNAGAR - BRJN
ISARDA - ISA
MANCHESWAR - MCS
RAMNAGAR - RMR
VEDAYAPALEM - VDE
BUDALUR - BAL
ISARWARA - ISH
MANCHIRYAL - MCI
RAMNAGAR BENGAL - RMRB
VEER - VEER
BUDAUN - BEM
ISLAMPUR - IPR
MANDA ROAD - MNF
RAMPUR - RMU
VELANKANNI - VLKN
BUDDIREDDIPPATI - BDY
ISMAILA HARYANA - ISM
MANDAGERE - MGF
RAMPUR BAZAR - RMPB
VELLANKANNI - VLNK
BUDHI - BDHY
ISMAILPUR - IMGE
MANDAL - MDL
RAMPUR DUMRA - RDUM
VELLORE CANT - VLR
BUDHLADA - BLZ
ITARSI JN - ET
MANDALGARH - MLGH
RAMPUR HAT - RPH
VENDODU - VDD
BUDNI - BNI
ITOLA - ITA
MANDAMARI - MMZ
RAMPURA PHUL - PUL
VENKATAGIRI - VKI
BUDVEL - BDVL
ITWARI - ITR
MANDAPAM - MMM
RANAGHAT JN - RHA
VENKATNAGRA - VKR
BULANDSHAHR - BSC
IZZATNAGAR - IZN
MANDASA ROAD - MMS
RANAPRATAPNAGAR - RPZ
VERAVAL - VRL
BUNDI - BUDI
JABALPUR - JBP
MANDASOR - MDS
RANAVAV - RWO
VERKA JN - VKA
BUNIADPUR - BNDP
JADCHERLA - JCL
MANDAVALLI - MDVL
RANCHI - RNC
VETAPALEMU - VTM
BURHANPUR - BAU
JAGADHRI - JUD
MANDAWAR M RD - MURD
RANCHI ROAD - RRME
VIDISHA - BHS
BURHAR - BUH
JAGADHRI WSHOP - JUDW
MANDERDISA - MYD
RANGALITING - RNGG
VIDYAPATINAGAR - VPN
BURHWAL - BUW
JAGADISHPUR - JGD
MANDI ADAMPUR - ADR
RANGAPARA NORTH - RPAN
VIDYASAGAR - VDS
BURNPUR - BURN
JAGATBELA - JTB
MANDI BAMORA - MABA
RANGIYA JN - RNY
VIJAY PUR - VJP
BUTARI - BTR
JAGDALPUR - JDB
MANDI DABWALI - MBY
RANI - RANI
VIJAYAWADA JN - BZA
BUTI BORI - BTBR
JAGESHARGANJ - JGJ
MANDI DHANAURA - MNDR
RANIBENNUR - RNR
VIJIYPUR JAMMU - VJPJ
BUXAR - BXR
JAGI ROAD - JID
MANDI DIP - MDDP
RANIGANJ - RNG
VIKARABAD JN - VKB
BYADGI - BYD
JAGRAON - JGN
MANDRAK - MXK
RANIWARA - RNV
VIKRAMGARH ALOT - VMA
C SHAHUMHARAJ T - KOP
JAI SAMAND ROAD - JYM
MANDUADIH - MUV
RANOLI - RNO
VIKRAMNAGAR - VRG
CANCONA - CNO
JAIPUR - JP
MANDYA - MYA
RANPUR - RUR
VILAVADE - VID
CARMELARAM - CRLM
JAIRAMNAGAR - JRMG
MANENDRAGARH - MDGR
RAOTI - RTI
VILAYATKALAN RD - VYK
CASTLE ROCK - CLR
JAIS - JAIS
MANGAL MAHUDI - MAM
RASRA - RSR
VILLUPARAM JN - VM
CHABUA - CHB
JAISALMER - JSM
MANGALAGIRI - MAG
RASULABAD - RUB
VINDHYACHAL - BDL
CHACHAURA BNGJ - CBK
JAITHARI - JTI
MANGALORE CNTL - MAQ
RASURIYA - RYS
VINUKONDA - VKN
CHAIBASA - CBSA
JAITWAR - JTW
MANGALORE JN - MAJN
RATANGARH JN - RTGH
VIRAMGAM JN - VG
CHAINPUR - CNPR
JAJIWAL - JWL
MANGAON - MNI
RATANPUR - RPUR
VIRAR - VR
CHAINWA - CW
JAJPUR K ROAD - JJKR
MANGLIYA GAON - MGG
RATANPURA - RTP
VIRAVASARAM - VVM
CHAJLI - CJL
JAKHAL JN - JHL
MANGOLPURI - MGLP
RATHDHANA - RDDE
VIRBHADRA - VRH
CHAKARPUR - CKK
JAKHALABANDHA - JKB
MANIKGARH - MAGH
RATLAM JN - RTM
VIRPUR - VRR
CHAKDAYALA - CKDL
JAKHALAUN - JLN
MANIKPUR JN - MKP
RATNAGIRI - RN
VIRUDUNAGAR JN - VPT
CHAKIA - CAA
JAKHANIAN - JKN
MANINAGAR - MAN
RAULI - RUL
VISAPUR - VPR
CHAKKI BANK - CHKB
JAKHAPURA - JKPR
MANJESHWAR - MJS
RAVER - RV
VISHAKAPATNAM - VSKP
CHAKRADHARPUR - CKP
JAKHIM - JHN
MANJHI - MHT
RAVINDRAKHANI - RVKH
VISHNUPURAM - VNUP
CHAKULIA - CKU
JAKHVADA - JKA
MANKAPUR JN - MUR
RAXAUL JN - RXL
VISHRAMBAG - VRB
CHALAKUDI - CKI
JALALGANJ - JLL
MANKAR - MNAE
RAY - RAY
VISHVAMITRI - VS
CHALISGAON JN - CSN
JALALPUR DHAI - JPD
MANKATHA - MKB
RAYAGADA - RGDA
VISWANATH CHRLI - VNE
CHAMPA - CPH
JALAMB JN - JM
MANMAD JN - MMR
RAYALCHERUVU - RLO
VITHISVARANKOL - VDL
CHAMPANER RD JN - CPN
JALANDHAR CANT - JRC
MANNARGUDI - MQ
RAYANAPAD - RYP
VIVEKA VIHAR - VVB
CHAND SIAU - CPS
JALANDHAR CITY - JUC
MANOHARGANJ - MNJ
RAYBAG - RBG
VIZIANAGRAM JN - VZM
CHANDA FORT - CAF
JALESAR ROAD - JLS
MANOHARPUR - MOU
RAZAMPETA - RJP
VRIDHACHALAM JN - VRI
CHANDAN NAGAR - CGR
JALESWAR - JER
MANSA - MSZ
RECHNI ROAD - RECH
VYARA - VYA
CHANDAULI MJHWR - CDMR
JALGAON JN - JL
MANSI JN - MNE
REJINAGAR - REJ
VYASNAGAR - VYN
CHANDAUSI JN - CH
JALNA - J
MANTHRALAYAM RD - MALM
REN - REN
WADAKANCHERI - WKI
CHANDERIYA - CNA
JALOR - JOR
MANUGURU - MUGR
RENGALI - RGL
WADHWAN CITY - WC
CHANDI MANDIR - CNDM
JALPAIGURI - JPG
MANWATH ROAD - MVO
RENIGUNTA JN - RU
WADI - WADI
CHANDIA ROAD - CHD
JALPAIGURI ROAD - JPE
MARAMJHIRI - MJY
RENUKUT - RNQ
WADIARAM - WDR
CHANDIGARH - CDG
JALSU - JAC
MARARIKULAM - MAKM
REOTI - ROI
WADRENGDISA - WDA
CHANDIL JN - CNI
JAM JODHPUR JN - JDH
MARAUDA - MXA
REOTI B KHERA - RBK
WADSA - WSA
CHANDLODIYA - CLDY
JAM WANTHALI - WTJ
MARGHERITA - MRG
REWA - REWA
WALAJAH ROAD JN - WJR
CHANDOK - CNK
JAMA - JAMA
MARIAHU - MAY
REWARI - RE
WANI - WANI
CHANDRAKONA RD - CDGR
JAMALPUR JN - JMP
MARIANI JN - MXN
RINGAS JN - RGS
WANKANER JN - WKR
CHANDRANATHPUR - CNE
JAMBARA - JMV
MARKAPUR ROAD - MRK
RISAMA - RSA
WANPARTI ROAD - WPR
CHANDRAPUR - CD
JAMDHA - JMD
MARKONA - MKO
RISHIKESH - RKSH
WANSJALIYA - WSJ
CHANDRAPURA - CRP
JAMIKUNTA - JMKT
MAROLI - MRL
RISIA - RS
WARANGAL - WL
CHANDUR - CND
JAMMU TAWI - JAT
MARTHIPALAYAM - MPLM
RITHI - REI
WARDHA JN - WR
CHANDUR BAZAR - CNDB
JAMNAGAR - JAM
MARWAR BHINMAL - MBNL
RJNDR NGR BIHAR - RJPB
WARIA - OYR
CHANGANASERI - CGY
JAMTARA - JMT
MARWAR JN - MJ
RNINGR JLPAIGRI - RQJ
WARIS ALEGANJ - WRS
CHANNAPATNA - CPT
JAMUI - JMU
MARWAR LOHWAT - MWT
ROBERTS GANJ - RBGJ
WARORA - WRR
CHANPATIA - CAI
JAMUNAMUKH - JMK
MARWAR MATHANYA - MMY
ROHA - ROHA
WASHIM - WHM
CHAPARMUKH JN - CPK
JANAKPUR ROAD - JNR
MARWAR MUNDWA - MDW
ROHTAK JN - ROK
WATHAR - WTR
CHARANMAHADEVI - SMD
JANDIALA - JNL
MARWASGRAM - MWJ
ROORKEE - RK
WAZERGANJ - WZJ
CHAREGAON - CRN
JANGAON - ZN
MASIT - MST
ROSHANPUR - RHN
WENA - WENA
CHARKHI DADRI - CKD
JANGHAI JN - JNH
MASKANWA - MSW
ROTEGAON - RGO
WHITEFIELD - WFD
CHARLAPALLI - CHZ
JANGIPUR ROAD - JRLE
MASUDAN - MSDN
ROURKELA - ROU
WIHIRGAON - VHGN
CHARVATTUR - CHV
JANWAL - JOA
MASUR - MSR
ROWRIAH SDG - RWH
WIRUR - WIRR
CHATA - CHJ
JAORA - JAO
MATHURA CANT - MRT
ROWTA BAGAN - RWTB
WYNDHAMGANJ - WDM
CHATRA - CTR
JAPLA - JPL
MATHURA JN - MTJ
ROZA JN - ROZA
YADGIR - YG
CHATRAPUR - CAP
JARAIKELA - JRA
MATHURAPUR - MUW
RUDAULI - RDL
YALVIGI - YLG
CHAU MAHLA - CMU
JARANDESHWAR - JSV
MATMARI - MTU
RUDRAPUR CITY - RUPC
YAMUNA BDG AGRA - JAB
CHAUK - CHOK
JARANGDIH - JAN
MAU AIMMA - MEM
RUKADI - RKD
YELHANKA JN - YNK
CHAUKHANDI - CHH
JAROLI - JRLI
MAU JN - MAU
RUNKHERA - RNH
YEOLA - YL
CHAUNRAH - CNH
JARWAL ROAD - JLD
MAU RANIPUR - MRPR
RUPAMAU - RUM
YERRAGUNTLA - YA
CHAURA - CUX
JASIDIH JN - JSME
MAUHARI - MZH
RUPAUND - RPD
YESVANTPUR JN - YPR
CHAURI CHAURA - CC
JASRA - JSR
MAULA ALI - MLY
RUPBAS - RBS
YUSUFPUR - YFP
CHAUSA - CSA
JASWANTNAGAR - JGR
MAUR - MAUR
RUPNAGAR - RPAR
ZAFARABAD JN - ZBD
CHAUTARA - CROA
JATH ROAD - JTRD
MAVELIKARA - MVLK
RUPNARAYANPUR - RNPR
ZAHIRABAD - ZB
CHAUTH KA BRWRA - CKB
JATINGA - JTG
MAVLI JN - MVJ
RUPRA ROAD - RPRD
ZAMANIA - ZNA
CHAWAPALL - CHA
JAUNPUR CITY - JOP
MAYILADUTURAI J - MV
RUPSA JN - ROP
ZAWAR - ZW
CHENGALPATTU - CGL
JAUNPUR JN - JNU
